3,3,3,3,3,3,3,3,3,3,3,3
0,0,0,0,0,0,0,0,10,10,10,0
10,10,10,10,10,9,10,10,10,10,10,10
10,10,0,0,0,0,0,0,0,0,0,0
7,7,7,7,7,7,7,7,7,7,7,7
0,0,0,0,0,0,0,0,0,0,0,9
7,7,0,7,1,7,7,7,1,7,0,7
8,9,1,8,8,8,0,8,8,8,1,8
0,0,0,0,0,0,0,0,0,0,0,0
