3,3,3,3,3,3,3,3,3,3,3,3
10,10,9,10,10,10,10,10,10,10,10,10
10,10,10,10,10,10,10,10,10,10,10,10
10,10,10,0,0,0,0,0,0,10,9,10
7,7,7,7,0,0,0,0,0,7,7,7
0,7,7,7,7,7,7,7,7,7,7,0
0,0,7,7,9,7,7,7,7,7,0,0
0,8,8,8,8,8,8,8,8,8,8,0
0,0,0,0,0,0,0,0,0,0,0,0