3,3,3,3,3,3,3,3,3,3,3,3
10,10,10,10,5,10,10,10,10,10,10,10
10,10,10,10,10,10,10,0,0,0,0,0
0,10,10,0,10,10,9,0,10,10,10,10
0,7,7,0,7,0,0,0,7,7,7,7
7,7,9,4,7,7,7,7,7,7,9,7
0,7,7,7,7,0,7,7,7,7,0,7
0,0,1,1,0,0,0,1,1,0,0,0
6,6,6,6,6,6,6,6,6,6,6,6
