3,3,3,3,3,3,3,3,3,3,3,3
0,9,0,10,0,10,10,0,10,0,10,0
10,10,10,1,10,10,10,10,1,10,10,10
0,10,0,10,0,10,10,0,10,0,9,0
7,7,7,1,7,7,7,7,7,7,7,7
0,7,0,7,0,7,7,0,9,0,7,0
7,1,7,7,7,7,7,7,7,7,1,7
0,8,0,8,0,8,8,0,8,0,8,0
0,0,0,0,0,0,0,0,0,0,0,0
