3,3,3,3,3,3,3,3,3,3,3,3
10,10,10,10,10,10,10,1,10,10,10,10
10,10,10,9,10,0,0,0,10,10,9,10
10,10,10,10,10,0,10,0,10,10,10,10
7,1,0,0,0,0,7,0,7,0,0,0
7,7,7,7,7,7,1,0,7,0,7,7
7,5,7,7,9,7,7,0,7,0,7,7
8,8,8,8,8,8,8,4,8,0,8,8
6,6,6,6,6,6,6,6,6,6,6,6
