1,3,0,0,0,0,0,0,0,0,0,3,1
10,10,10,10,9,10,0,10,9,10,10,10,10
10,10,10,10,10,10,10,10,10,10,10,10,10
10,10,0,0,0,0,0,0,0,0,0,10,10
7,7,7,7,0,6,6,6,0,7,7,7,7
7,7,1,7,0,6,9,6,0,7,1,7,7
7,7,7,7,0,6,6,6,0,7,7,7,7
8,8,8,8,1,1,1,1,1,8,8,8,8
