3,3,3,3,3,3,3,3,3,3,3,3
10,10,10,10,10,10,10,10,10,1,1,1
10,10,10,10,9,10,10,0,10,1,5,1
10,10,10,0,0,0,10,0,10,1,1,1
7,7,7,7,7,0,9,0,7,7,7,7
7,1,1,1,7,0,7,0,0,0,7,7
7,1,5,1,7,0,7,7,9,0,0,7
8,1,1,1,8,0,0,8,8,8,8,8
6,6,6,6,6,6,6,6,6,6,6,6
