3,3,3,3,3,3,3,3,3,3,3,3
10,10,10,10,10,10,10,10,10,10,10,10
0,10,10,9,10,10,10,10,9,10,10,0
0,10,10,10,10,0,0,10,10,10,10,0
0,0,7,7,7,7,7,7,7,7,0,0
0,0,0,7,7,1,9,7,7,0,0,0
0,0,0,0,7,7,7,7,0,0,0,0
0,0,0,0,0,8,8,0,0,0,0,0
6,6,6,6,6,6,6,6,6,6,6,6
