3,3,3,3,3,3,3,3,3,3,3,3
0,0,0,0,0,0,0,0,0,0,10,10
10,10,1,10,1,10,1,10,10,0,9,10
10,0,0,0,0,0,0,0,10,0,1,10
7,7,7,7,7,7,7,7,7,7,1,7
7,9,7,0,0,0,0,0,0,0,0,0
7,7,7,7,7,7,0,7,7,7,7,7
0,8,8,8,0,8,8,8,0,8,9,8
6,6,6,6,6,6,6,6,6,6,6,6
