0,0,3,3,3,0,0,0,0,0,0,0,0
0,0,10,10,10,0,10,10,10,10,10,10,10
0,0,10,10,10,0,10,10,10,10,10,9,10
1,10,10,9,10,0,10,10,0,10,10,10,10
7,7,7,7,7,0,7,7,0,0,0,0,0
7,7,0,0,0,0,7,7,7,6,6,6,7
7,7,0,7,7,7,7,4,7,6,9,6,7
8,8,8,8,8,8,8,8,8,6,6,6,8
