3,3,3,3,3,3,3,3,3,3,3,3
0,0,10,10,10,10,10,10,10,10,0,0
0,0,0,0,10,5,10,10,9,10,10,0
0,0,0,0,10,10,10,10,10,10,0,0
0,0,0,0,0,0,0,7,9,7,7,0
0,0,0,0,0,0,0,7,7,7,0,0
0,0,0,1,7,7,1,7,4,7,7,0
0,0,9,8,8,8,8,8,8,0,0,0
6,6,6,6,6,6,6,6,6,6,6,6
